################################
#                              #
#  ######          ######      #
#  ##  ##          ##  ##      #
#  ##  ##          ##  ##      #
#  ######          ######      #
#                              #
#                              #
#        ######  ######        #
#        ##  ##  ##  ##        #
#        ##  ##  ##  ##        #
#        ######  ######        #
#                              #
#      ######          ######  #
#      ##  ##          ##  ##  #
#      ##  ##          ##  ##  #
#      ######          ######  #
################################
