################################
#                              #
#                              #
#       ##   ##  ##  ###       #
#       #                      #
#                      #       #
#                      #       #
#       #                      #
#       #                      #
#                      #       #
#                      #       #
#       #                      #
#       #              #       #
#       ###   ##  ##  ##       #
#                              #
#                              #
#                              #
################################
