################################
#                              #
#                              #
#       ##################     #
#       ##              ##     #
#       ##              ##     #
#       ##              ##     #
#       ##              ##     #
#       ##              ##     #
#       ##              ##     #
#       ##              ##     #
#       ##              ##     #
#       ##              ##     #
#       ##################     #
#                              #
#                              #
#                              #
################################
