################################
#                              #
#  ####                  ####  #
#  ####                  ####  #
#  ##                      ##  #
#  ##                      ##  #
#                              #
#                              #
#                              #
#                              #
#                              #
#                              #
#  ##                      ##  #
#  ##                      ##  #
#  ####                  ####  #
#  ####                  ####  #
#                              #
################################
