################################
#                              #
#                              #
#   ###                  ###   #
#   #                      #   #
#   #                      #   #
#                              #
#                              #
#                              #
#                              #
#                              #
#                              #
#   #                      #   #
#   #                      #   #
#   ###                  ###   #
#                              #
#                              #
################################
