################################
#                              #
#                              #
#       ##        ##           #
#       ##        ##           #
#                              #
#                              #
#   ##          ##          ## #
#   ##          ##          ## #
#                              #
#                              #
#           ##        ##       #
#           ##        ##       #
#                              #
#                              #
#                              #
#                              #
################################
